,team_id,season_id,league_id,team_income_fee,team_expenditure_fee,overall_balance_fee
0,631,2015,2,87490000,96500000,-9010000
1,281,2015,2,67440000,208470000,-141030000
2,11,2015,2,2500000,26500000,-24000000
3,985,2015,2,100670000,156000000,-55330000
4,148,2015,2,87250000,71000000,16250000
5,31,2015,2,90550000,126500000,-35950000
6,180,2015,2,52700000,60100000,-7400000
7,2288,2015,2,16810000,21810000,-5000000
8,512,2015,2,23200000,53650000,-30450000
9,873,2015,2,5400000,28800000,-23400000
10,29,2015,2,11000000,48200000,-37200000
11,379,2015,2,18520000,52700000,-34180000
12,984,2015,2,12920000,42900000,-29980000
13,1003,2015,2,9450000,49900000,-40450000
14,762,2015,2,5630000,107910000,-102280000
15,289,2015,2,11000000,66050000,-55050000
16,405,2015,2,64700000,66550000,-1850000
17,989,2015,2,650000,55110000,-54460000
18,1010,2015,2,9750000,82800000,-73050000
19,1123,2015,2,21490000,50500000,-29010000
20,131,2015,3,38300000,51000000,-12700000
21,418,2015,3,31650000,92900000,-61250000
22,13,2015,3,152000000,119000000,33000000
23,1049,2015,3,50000000,143900000,-93900000
24,368,2015,3,61450000,44000000,17450000
25,1050,2015,3,37560000,47200000,-9640000
26,621,2015,3,0,10000000,-10000000
27,940,2015,3,18500000,16300000,2200000
28,1084,2015,3,46800000,8650000,38150000
29,714,2015,3,15200000,4450000,10750000
30,367,2015,3,0,400000,-400000
31,681,2015,3,1000000,26100000,-25100000
32,3368,2015,3,0,6550000,-6550000
33,3709,2015,3,4100000,270000,3830000
34,16795,2015,3,11170000,3850000,7320000
35,1533,2015,3,0,3700000,-3700000
36,472,2015,3,0,6400000,-6400000
37,2448,2015,3,0,0,0
38,150,2015,3,1050000,8850000,-7800000
39,27,2015,4,33000000,90750000,-57750000
40,82,2015,4,111300000,68100000,43200000
41,18,2015,4,15700000,38000000,-22300000
42,15,2015,4,63250000,58000000,5250000
43,167,2015,4,26900000,16700000,10200000
44,33,2015,4,57200000,37100000,20100000
45,16,2015,4,42550000,20000000,22550000
46,533,2015,4,57150000,23400000,33750000
47,24,2015,4,12100000,11820000,280000
48,86,2015,4,19450000,12880000,6570000
49,39,2015,4,34200000,13850000,20350000
50,3,2015,4,13050000,14780000,-1730000
51,42,2015,4,13500000,18400000,-4900000
52,79,2015,4,20550000,15670000,4880000
53,44,2015,4,4920000,7300000,-2380000
54,41,2015,4,13200000,21850000,-8650000
55,4795,2015,4,0,6200000,-6200000
56,105,2015,4,0,1100000,-1100000
57,506,2015,5,81280000,185500000,-104220000
58,12,2015,5,134250000,60850000,73400000
59,398,2015,5,2370000,31250000,-28880000
60,430,2015,5,26850000,24900000,1950000
61,6195,2015,5,18290000,42700000,-24410000
62,252,2015,5,43150000,16700000,26450000
63,1038,2015,5,16820000,34670000,-17850000
64,46,2015,5,115320000,102450000,12870000
65,416,2015,5,19750000,28050000,-8300000
66,5,2015,5,11160000,102280000,-91120000
67,6574,2015,5,25000000,30700000,-5700000
68,276,2015,5,2050000,6300000,-4250000
69,862,2015,5,15400000,6130000,9270000
70,410,2015,5,74120000,21420000,52700000
71,800,2015,5,37950000,26680000,11270000
72,1025,2015,5,800000,26630000,-25830000
73,8970,2015,5,200000,400000,-200000
74,583,2015,6,22900000,116100000,-93200000
75,1041,2015,6,26800000,41100000,-14300000
76,162,2015,6,175400000,101000000,74400000
77,244,2015,6,54450000,19750000,34700000
78,618,2015,6,23200000,20300000,2900000
79,40,2015,6,22300000,11000000,11300000
80,969,2015,6,4000000,2730000,1270000
81,1082,2015,6,35250000,12900000,22350000
82,273,2015,6,10600000,5640000,4960000
83,855,2015,6,6000000,1950000,4050000
84,417,2015,6,14000000,4100000,9900000
85,595,2015,6,1700000,0,1700000
86,1162,2015,6,14000000,6050000,7950000
87,995,2015,6,17550000,7000000,10550000
88,1421,2015,6,1500000,2400000,-900000
89,1158,2015,6,18500000,9930000,8570000
90,415,2015,6,10500000,2900000,7600000
91,1420,2015,6,5900000,0,5900000
92,1095,2015,6,7300000,300000,7000000
93,3558,2015,6,0,0,0
94,1003,2016,2,66050000,92100000,-26050000
95,11,2016,2,10350000,113000000,-102650000
96,148,2016,2,52300000,83500000,-31200000
97,281,2016,2,35350000,216250000,-180900000
98,985,2016,2,47250000,185000000,-137750000
99,180,2016,2,85050000,68900000,16150000
100,379,2016,2,41000000,83500000,-42500000
101,31,2016,2,85380000,79900000,5480000
102,512,2016,2,3800000,42170000,-38370000
103,631,2016,2,108900000,132800000,-23900000
104,29,2016,2,60800000,86000000,-25200000
105,2288,2016,2,49300000,58100000,-8800000
106,1010,2016,2,58100000,70450000,-12350000
107,984,2016,2,26980000,37900000,-10920000
108,873,2016,2,50200000,101200000,-51000000
109,989,2016,2,23690000,40690000,-17000000
110,289,2016,2,23770000,41900000,-18130000
111,1132,2016,2,1200000,45600000,-44400000
112,641,2016,2,13500000,47950000,-34450000
113,3008,2016,2,28900000,40000000,-11100000
114,131,2016,3,33800000,124750000,-90950000
115,418,2016,3,37500000,30000000,7500000
116,13,2016,3,44000000,78800000,-34800000
117,621,2016,3,0,0,0
118,1050,2016,3,67250000,55950000,11300000
119,150,2016,3,8000000,20900000,-12900000
120,368,2016,3,93450000,81700000,11750000
121,1108,2016,3,0,6330000,-6330000
122,1244,2016,3,200000,5450000,-5250000
123,714,2016,3,6000000,18400000,-12400000
124,16795,2016,3,31600000,11580000,20020000
125,1533,2016,3,5000000,8600000,-3600000
126,940,2016,3,19800000,8400000,11400000
127,2448,2016,3,0,1000000,-1000000
128,681,2016,3,11000000,18000000,-7000000
129,1084,2016,3,0,12540000,-12540000
130,1049,2016,3,121900000,36000000,85900000
131,472,2016,3,200000,2900000,-2700000
132,331,2016,3,3750000,2200000,1550000
133,27,2016,4,52300000,70000000,-17700000
134,16,2016,4,111000000,141100000,-30100000
135,15,2016,4,23700000,63300000,-39600000
136,18,2016,4,45100000,41250000,3850000
137,33,2016,4,61300000,43300000,18000000
138,39,2016,4,25700000,29210000,-3510000
139,44,2016,4,5000000,6700000,-1700000
140,82,2016,4,94450000,81050000,13400000
141,3,2016,4,19000000,8350000,10650000
142,41,2016,4,8750000,43950000,-35200000
143,4795,2016,4,4550000,7950000,-3400000
144,167,2016,4,15050000,23700000,-8650000
145,86,2016,4,27200000,23700000,3500000
146,105,2016,4,5200000,4100000,1100000
147,533,2016,4,37000000,27440000,9560000
148,24,2016,4,12050000,3800000,8250000
149,60,2016,4,5150000,16780000,-11630000
150,23826,2016,4,100000,95950000,-95850000
151,800,2016,5,41330000,15940000,25390000
152,1025,2016,5,16980000,31300000,-14320000
153,1390,2016,5,11620000,9720000,1900000
154,862,2016,5,6280000,12570000,-6290000
155,4083,2016,5,7750000,5950000,1800000
156,430,2016,5,31050000,15730000,15320000
157,252,2016,5,50300000,27200000,23100000
158,46,2016,5,18500000,164630000,-146130000
159,506,2016,5,176930000,170230000,6700000
160,398,2016,5,28700000,32700000,-4000000
161,5,2016,5,25150000,29560000,-4410000
162,6195,2016,5,116810000,99090000,17720000
163,2921,2016,5,22270000,14290000,7980000
164,12,2016,5,43430000,102500000,-59070000
165,1038,2016,5,80700000,39650000,41050000
166,6574,2016,5,27800000,27510000,290000
167,416,2016,5,26430000,28770000,-2340000
168,410,2016,5,32230000,26500000,5730000
169,583,2016,6,59800000,134500000,-74700000
170,1041,2016,6,27300000,28600000,-1300000
171,162,2016,6,18450000,50500000,-32050000
172,417,2016,6,15800000,15250000,550000
173,1082,2016,6,47000000,20700000,26300000
174,618,2016,6,2250000,7000000,-4750000
175,1162,2016,6,11000000,4250000,6750000
176,273,2016,6,55300000,2270000,53030000
177,1420,2016,6,4400000,5200000,-800000
178,595,2016,6,7000000,250000,6750000
179,40,2016,6,2600000,11850000,-9250000
180,969,2016,6,19400000,6400000,13000000
181,244,2016,6,81490000,53000000,28490000
182,995,2016,6,2650000,5000000,-2350000
183,1158,2016,6,32150000,8600000,23550000
184,855,2016,6,2500000,0,2500000
185,415,2016,6,10000000,13000000,-3000000
186,1159,2016,6,10900000,2300000,8600000
187,2969,2016,6,1250000,3150000,-1900000
188,347,2016,6,775000,400000,375000
189,631,2017,2,194600000,260500000,-65900000
190,148,2017,2,103800000,121000000,-17200000
191,281,2017,2,91350000,317500000,-226150000
192,31,2017,2,184500000,173650000,10850000
193,11,2017,2,162000000,152850000,9150000
194,985,2017,2,45500000,198400000,-152900000
195,29,2017,2,126380000,203200000,-76820000
196,180,2017,2,98350000,61250000,37100000
197,989,2017,2,0,34300000,-34300000
198,984,2017,2,2050000,53500000,-51450000
199,379,2017,2,69020000,56800000,12220000
200,1003,2017,2,50100000,83850000,-33750000
201,512,2017,2,35140000,57700000,-22560000
202,873,2017,2,3000000,48950000,-45950000
203,2288,2017,2,81100000,73390000,7710000
204,1132,2017,2,50000000,35740000,14260000
205,1010,2017,2,18740000,73400000,-54660000
206,762,2017,2,21220000,46500000,-25280000
207,1237,2017,2,400000,66500000,-66100000
208,1110,2017,2,6460000,56750000,-50290000
209,418,2017,3,132500000,40500000,92000000
210,131,2017,3,232500000,380100000,-147600000
211,13,2017,3,104000000,95600000,8400000
212,368,2017,3,81600000,78050000,3550000
213,1050,2017,3,68000000,46100000,21900000
214,681,2017,3,53000000,25500000,27500000
215,621,2017,3,65000000,32000000,33000000
216,714,2017,3,10500000,17050000,-6550000
217,1108,2017,3,7500000,12330000,-4830000
218,1533,2017,3,10000000,10250000,-250000
219,1084,2017,3,33400000,10500000,22900000
220,1049,2017,3,16550000,55000000,-38450000
221,940,2017,3,13200000,26800000,-13600000
222,472,2017,3,25700000,350000,25350000
223,150,2017,3,27070000,38500000,-11430000
224,1244,2017,3,130000,6550000,-6420000
225,3368,2017,3,13850000,10000000,3850000
226,12321,2017,3,0,8750000,-8750000
227,3709,2017,3,1600000,12900000,-11300000
228,27,2017,4,32250000,116500000,-84250000
229,23826,2017,4,24540000,63500000,-38960000
230,16,2017,4,275950000,122590000,153360000
231,533,2017,4,45750000,14700000,31050000
232,3,2017,4,7450000,40000000,-32550000
233,44,2017,4,18000000,14000000,4000000
234,60,2017,4,27800000,19650000,8150000
235,86,2017,4,8900000,18600000,-9700000
236,18,2017,4,31080000,37250000,-6170000
237,33,2017,4,7100000,49300000,-42200000
238,24,2017,4,4920000,19200000,-14280000
239,15,2017,4,91100000,51000000,40100000
240,167,2017,4,7900000,7550000,350000
241,41,2017,4,5550000,19000000,-13450000
242,39,2017,4,24850000,16550000,8300000
243,82,2017,4,36000000,72750000,-36750000
244,79,2017,4,7600000,30900000,-23300000
245,42,2017,4,250000,19000000,-18750000
246,800,2017,5,78040000,66590000,11450000
247,4171,2017,5,3980000,23480000,-19500000
248,1025,2017,5,0,13000000,-13000000
249,1390,2017,5,19880000,31090000,-11210000
250,862,2017,5,17670000,2950000,14720000
251,4083,2017,5,0,3000000,-3000000
252,430,2017,5,93580000,79500000,14080000
253,252,2017,5,46720000,14170000,32550000
254,276,2017,5,8050000,3050000,5000000
255,46,2017,5,79240000,137630000,-58390000
256,506,2017,5,145650000,177600000,-31950000
257,398,2017,5,73920000,28250000,45670000
258,5,2017,5,39700000,186480000,-146780000
259,6195,2017,5,17450000,68000000,-50550000
260,12,2017,5,156500000,91300000,65200000
261,1038,2017,5,71460000,51000000,20460000
262,6574,2017,5,19250000,37100000,-17850000
263,416,2017,5,79800000,26380000,53420000
264,410,2017,5,17700000,22590000,-4890000
265,1416,2017,6,8000000,6630000,1370000
266,1420,2017,6,26000000,12400000,13600000
267,40,2017,6,28250000,32600000,-4350000
268,1162,2017,6,6000000,6950000,-950000
269,2969,2017,6,15000000,5500000,9500000
270,855,2017,6,5950000,1380000,4570000
271,1082,2017,6,31100000,76500000,-45400000
272,1041,2017,6,119550000,58050000,61500000
273,244,2017,6,2750000,62000000,-59250000
274,347,2017,6,22850000,3600000,19250000
275,162,2017,6,199500000,122400000,77100000
276,969,2017,6,20800000,5700000,15100000
277,995,2017,6,10000000,11300000,-1300000
278,417,2017,6,27500000,26300000,1200000
279,583,2017,6,98400000,238000000,-139600000
280,273,2017,6,15800000,53900000,-38100000
281,618,2017,6,15500000,19300000,-3800000
282,667,2017,6,2000000,5400000,-3400000
283,415,2017,6,13000000,3500000,9500000
284,1095,2017,6,0,0,0
285,281,2018,2,57600000,78590000,-20990000
286,985,2018,2,30550000,82700000,-52150000
287,148,2018,2,5350000,0,5350000
288,31,2018,2,41320000,182200000,-140880000
289,631,2018,2,83250000,208800000,-125550000
290,11,2018,2,9100000,80150000,-71050000
291,1132,2018,2,8000000,33000000,-25000000
292,29,2018,2,28650000,99800000,-71150000
293,1003,2018,2,95800000,114600000,-18800000
294,762,2018,2,51050000,59750000,-8700000
295,873,2018,2,350000,11850000,-11500000
296,989,2018,2,20200000,91600000,-71400000
297,379,2018,2,13770000,100900000,-87130000
298,1010,2018,2,51840000,30100000,21740000
299,1237,2018,2,13620000,87120000,-73500000
300,1110,2018,2,12330000,50700000,-38370000
301,180,2018,2,26100000,62250000,-36150000
302,543,2018,2,23300000,112750000,-89450000
303,603,2018,2,0,40200000,-40200000
304,931,2018,2,5350000,116500000,-111150000
305,621,2018,3,80000000,32900000,47100000
306,13,2018,3,57900000,168000000,-110100000
307,1244,2018,3,24600000,18900000,5700000
308,1108,2018,3,9000000,10000000,-1000000
309,131,2018,3,146050000,141100000,4950000
310,3709,2018,3,5000000,27250000,-22250000
311,12321,2018,3,3300000,10200000,-6900000
312,3368,2018,3,41500000,26700000,14800000
313,940,2018,3,35700000,30000000,5700000
314,714,2018,3,30800000,22100000,8700000
315,150,2018,3,49300000,44500000,4800000
316,418,2018,3,136100000,164750000,-28650000
317,681,2018,3,32800000,12000000,20800000
318,1533,2018,3,7750000,8000000,-250000
319,368,2018,3,93800000,81050000,12750000
320,1049,2018,3,68800000,129200000,-60400000
321,1050,2018,3,54800000,92900000,-38100000
322,367,2018,3,13000000,12300000,700000
323,366,2018,3,0,10100000,-10100000
324,27,2018,4,84000000,14000000,70000000
325,33,2018,4,46150000,62200000,-16050000
326,533,2018,4,6120000,32000000,-25880000
327,16,2018,4,114200000,90500000,23700000
328,15,2018,4,45000000,31500000,13500000
329,23826,2018,4,72750000,65630000,7120000
330,79,2018,4,13250000,45760000,-32510000
331,24,2018,4,18900000,28950000,-10050000
332,18,2018,4,32950000,32550000,400000
333,44,2018,4,16900000,16000000,900000
334,86,2018,4,26850000,25800000,1050000
335,167,2018,4,2850000,6650000,-3800000
336,42,2018,4,13540000,18520000,-4980000
337,39,2018,4,56100000,30000000,26100000
338,60,2018,4,22680000,18400000,4280000
339,82,2018,4,800000,36000000,-35200000
340,38,2018,4,600000,7500000,-6900000
341,4,2018,4,0,4850000,-4850000
342,800,2018,5,25060000,60800000,-35740000
343,1025,2018,5,44990000,31220000,13770000
344,1390,2018,5,7850000,22500000,-14650000
345,862,2018,5,17620000,9470000,8150000
346,430,2018,5,43390000,60770000,-17380000
347,8970,2018,5,800000,9560000,-8760000
348,252,2018,5,84360000,59070000,25290000
349,46,2018,5,91170000,97600000,-6430000
350,506,2018,5,112540000,263200000,-150660000
351,398,2018,5,38600000,51280000,-12680000
352,5,2018,5,88100000,194640000,-106540000
353,6195,2018,5,100800000,71000000,29800000
354,130,2018,5,596000,20400000,-19804000
355,12,2018,5,150470000,166350000,-15880000
356,1038,2018,5,90120000,56450000,33670000
357,6574,2018,5,50380000,53970000,-3590000
358,2722,2018,5,1850000,21900000,-20050000
359,416,2018,5,17200000,53150000,-35950000
360,410,2018,5,13530000,52900000,-39370000
361,1416,2018,6,10000000,7490000,2510000
362,1420,2018,6,21000000,4450000,16550000
363,40,2018,6,50700000,21460000,29240000
364,1162,2018,6,14500000,9950000,4550000
365,2969,2018,6,4000000,9200000,-5200000
366,855,2018,6,4000000,3500000,500000
367,1082,2018,6,69700000,8900000,60800000
368,1041,2018,6,90100000,46450000,43650000
369,244,2018,6,32850000,66000000,-33150000
370,162,2018,6,367250000,145850000,221400000
371,969,2018,6,25500000,10150000,15350000
372,995,2018,6,11200000,14350000,-3150000
373,417,2018,6,61700000,28000000,33700000
374,1160,2018,6,0,3150000,-3150000
375,583,2018,6,114000000,262000000,-148000000
376,1421,2018,6,11000000,15500000,-4500000
377,273,2018,6,18500000,18000000,500000
378,618,2018,6,18700000,15000000,3700000
379,667,2018,6,14000000,15750000,-1750000
380,415,2018,6,35500000,18450000,17050000
381,281,2019,2,71000000,166820000,-95820000
382,31,2019,2,48000000,10400000,37600000
383,631,2019,2,157270000,45000000,112270000
384,148,2019,2,64500000,150500000,-86000000
385,11,2019,2,53650000,160800000,-107150000
386,985,2019,2,81180000,236800000,-155620000
387,543,2019,2,24100000,116700000,-92600000
388,29,2019,2,87800000,121000000,-33200000
389,1003,2019,2,88500000,104300000,-15800000
390,379,2019,2,55480000,119800000,-64320000
391,1010,2019,2,25400000,56000000,-30600000
392,873,2019,2,55380000,7600000,47780000
393,762,2019,2,35640000,72900000,-37260000
394,989,2019,2,34630000,54910000,-20280000
395,1132,2019,2,13550000,23850000,-10300000
396,180,2019,2,27300000,61500000,-34200000
397,1237,2019,2,8500000,61740000,-53240000
398,1123,2019,2,2200000,8820000,-6620000
399,350,2019,2,350000,70500000,-70150000
400,405,2019,2,3000000,159500000,-156500000
401,131,2019,3,152900000,298500000,-145600000
402,13,2019,3,316300000,247350000,68950000
403,418,2019,3,136800000,355500000,-218700000
404,3709,2019,3,11250000,21500000,-10250000
405,1049,2019,3,56300000,75000000,-18700000
406,368,2019,3,131450000,188730000,-57280000
407,621,2019,3,0,0,0
408,681,2019,3,9500000,31750000,-22250000
409,714,2019,3,60000000,61500000,-1500000
410,1108,2019,3,22500000,11770000,10730000
411,1533,2019,3,27000000,17300000,9700000
412,1244,2019,3,40820000,16450000,24370000
413,150,2019,3,72000000,96450000,-24450000
414,1050,2019,3,69300000,43800000,25500000
415,3368,2019,3,14900000,14600000,300000
416,366,2019,3,8000000,1400000,6600000
417,940,2019,3,40650000,24600000,16050000
418,331,2019,3,300000,14450000,-14150000
419,16795,2019,3,300000,11240000,-10940000
420,237,2019,3,0,7500000,-7500000
421,27,2019,4,54000000,139500000,-85500000
422,16,2019,4,132250000,148500000,-16250000
423,23826,2019,4,45250000,86500000,-41250000
424,15,2019,4,33500000,98200000,-64700000
425,18,2019,4,34100000,40500000,-6400000
426,82,2019,4,14300000,34800000,-20500000
427,24,2019,4,114800000,82640000,32160000
428,86,2019,4,0,13950000,-13950000
429,533,2019,4,121400000,55850000,65550000
430,38,2019,4,11600000,11150000,450000
431,44,2019,4,23450000,110700000,-87250000
432,39,2019,4,27000000,29700000,-2700000
433,60,2019,4,8100000,17500000,-9400000
434,33,2019,4,19450000,29500000,-10050000
435,167,2019,4,20000000,33000000,-13000000
436,3,2019,4,6850000,20250000,-13400000
437,127,2019,4,5800000,750000,5050000
438,89,2019,4,1250000,10050000,-8800000
439,800,2019,5,105100000,60060000,45040000
440,1025,2019,5,28680000,67040000,-38360000
441,19,2019,5,100000,18650000,-18550000
442,1390,2019,5,18860000,40100000,-21240000
443,430,2019,5,15320000,56540000,-41220000
444,252,2019,5,66350000,50370000,15980000
445,276,2019,5,43670000,21190000,22480000
446,46,2019,5,66740000,191720000,-124980000
447,506,2019,5,203140000,230500000,-27360000
448,398,2019,5,35350000,49950000,-14600000
449,1005,2019,5,450000,6200000,-5750000
450,5,2019,5,59230000,124080000,-64850000
451,6195,2019,5,48720000,206520000,-157800000
452,130,2019,5,18160000,23310000,-5150000
453,12,2019,5,106380000,117400000,-11020000
454,1038,2019,5,74590000,65250000,9340000
455,6574,2019,5,51950000,66340000,-14390000
456,2722,2019,5,39700000,26150000,13550000
457,416,2019,5,24400000,28800000,-4400000
458,410,2019,5,60270000,12600000,47670000
459,1416,2019,6,5440000,18150000,-12710000
460,1420,2019,6,34000000,10400000,23600000
461,40,2019,6,62250000,17000000,45250000
462,3911,2019,6,500000,7500000,-7000000
463,2969,2019,6,24500000,10470000,14030000
464,1082,2019,6,151000000,99400000,51600000
465,1041,2019,6,160320000,126000000,34320000
466,244,2019,6,27250000,27000000,250000
467,347,2019,6,2600000,14350000,-11750000
468,1160,2019,6,20500000,9850000,10650000
469,162,2019,6,83750000,200000000,-116250000
470,969,2019,6,40000000,20300000,19700000
471,995,2019,6,38500000,18750000,19750000
472,417,2019,6,23110000,52200000,-29090000
473,583,2019,6,105900000,95000000,10900000
474,1421,2019,6,26600000,18700000,7900000
475,273,2019,6,54500000,58100000,-3600000
476,618,2019,6,45850000,13450000,32400000
477,667,2019,6,21500000,11000000,10500000
478,415,2019,6,17150000,14000000,3150000
479,11,2020,2,19150000,86000000,-66850000
480,405,2020,2,2770000,101350000,-98580000
481,1237,2020,2,20600000,28500000,-7900000
482,1132,2020,2,2300000,1100000,1200000
483,631,2020,2,57150000,247200000,-190050000
484,873,2020,2,20000000,22400000,-2400000
485,29,2020,2,4430000,74370000,-69940000
486,931,2020,2,0,37250000,-37250000
487,399,2020,2,0,127800000,-127800000
488,1003,2020,2,53770000,59400000,-5630000
489,31,2020,2,17200000,84050000,-66850000
490,281,2020,2,64000000,173400000,-109400000
491,985,2020,2,19500000,83800000,-64300000
492,762,2020,2,275000,39000000,-38725000
493,350,2020,2,0,62700000,-62700000
494,180,2020,2,26300000,37300000,-11000000
495,148,2020,2,13300000,110500000,-97200000
496,984,2020,2,8100000,42140000,-34040000
497,379,2020,2,45410000,54700000,-9290000
498,543,2020,2,79200000,87590000,-8390000
499,418,2020,3,104200000,0,104200000
500,131,2020,3,149800000,112000000,37800000
501,13,2020,3,83300000,91000000,-7700000
502,368,2020,3,19680000,74350000,-54670000
503,1050,2020,3,26650000,36500000,-9850000
504,3709,2020,3,9750000,22050000,-12300000
505,681,2020,3,28250000,10000000,18250000
506,1049,2020,3,87850000,50000,87800000
507,621,2020,3,0,12000000,-12000000
508,16795,2020,3,0,20500000,-20500000
509,331,2020,3,3450000,9150000,-5700000
510,3368,2020,3,5000000,4000000,1000000
511,150,2020,3,43700000,0,43700000
512,366,2020,3,12100000,9850000,2250000
513,2687,2020,3,0,10100000,-10100000
514,1533,2020,3,150000,2000000,-1850000
515,1108,2020,3,4880000,0,4880000
516,940,2020,3,2500000,3000000,-500000
517,1531,2020,3,7300000,6100000,1200000
518,27,2020,4,22250000,66250000,-44000000
519,16,2020,4,5500000,50000000,-44500000
520,23826,2020,4,77500000,58000000,19500000
521,18,2020,4,0,13500000,-13500000
522,15,2020,4,91000000,46200000,44800000
523,533,2020,4,17750000,4000000,13750000
524,82,2020,4,11100000,22000000,-10900000
525,60,2020,4,37950000,14350000,23600000
526,24,2020,4,17700000,10750000,6950000
527,44,2020,4,10450000,31250000,-20800000
528,89,2020,4,6920000,1700000,5220000
529,33,2020,4,8000000,2000000,6000000
530,39,2020,4,13700000,2000000,11700000
531,3,2020,4,15000000,18500000,-3500000
532,167,2020,4,8400000,10300000,-1900000
533,86,2020,4,11700000,11000000,700000
534,10,2020,4,100000,500000,-400000
535,79,2020,4,7500000,14950000,-7450000
536,800,2020,5,75400000,62040000,13360000
537,4171,2020,5,1000000,11600000,-10600000
538,1025,2020,5,5000000,3150000,1850000
539,1390,2020,5,42660000,34180000,8480000
540,4083,2020,5,0,5490000,-5490000
541,430,2020,5,59890000,55300000,4590000
542,252,2020,5,67290000,64680000,2610000
543,276,2020,5,5400000,18950000,-13550000
544,46,2020,5,82950000,126500000,-43550000
545,506,2020,5,110560000,158010000,-47450000
546,398,2020,5,7850000,41700000,-33850000
547,5,2020,5,52090000,31920000,20170000
548,6195,2020,5,123060000,77250000,45810000
549,130,2020,5,4000000,104330000,-100330000
550,12,2020,5,49000000,72100000,-23100000
551,1038,2020,5,12100000,17750000,-5650000
552,6574,2020,5,62360000,29660000,32700000
553,3522,2020,5,1960000,5140000,-3180000
554,416,2020,5,27000000,46700000,-19700000
555,410,2020,5,31550000,21500000,10050000
556,583,2020,6,400000,62000000,-61600000
557,244,2020,6,32050000,17420000,14630000
558,273,2020,6,55420000,70560000,-15140000
559,1082,2020,6,104180000,40430000,63750000
560,417,2020,6,20510000,29230000,-8720000
561,1421,2020,6,17000000,11200000,5800000
562,1041,2020,6,50600000,36690000,13910000
563,969,2020,6,0,13100000,-13100000
564,667,2020,6,500000,12000000,-11500000
565,162,2020,6,13530000,52700000,-39170000
566,1420,2020,6,10700000,11250000,-550000
567,40,2020,6,17000000,0,17000000
568,995,2020,6,2000000,5000000,-3000000
569,3911,2020,6,12000000,16100000,-4100000
570,347,2020,6,10000000,14700000,-4700000
571,2969,2020,6,17000000,15800000,1200000
572,618,2020,6,44100000,5600000,38500000
573,1160,2020,6,2500000,11250000,-8750000
574,1158,2020,6,6500000,26500000,-20000000
575,826,2020,6,0,19000000,-19000000
576,11,2021,2,31400000,167400000,-136000000
577,405,2021,2,127000000,129800000,-2800000
578,1148,2021,2,1000000,36700000,-35700000
579,1237,2021,2,78500000,75000000,3500000
580,1132,2021,2,40500000,49400000,-8900000
581,631,2021,2,148940000,118000000,30940000
582,873,2021,2,0,85620000,-85620000
583,29,2021,2,46000000,39500000,6500000
584,399,2021,2,0,59300000,-59300000
585,1003,2021,2,4000000,67600000,-63600000
586,31,2021,2,29550000,87000000,-57450000
587,281,2021,2,93800000,138900000,-45100000
588,985,2021,2,31100000,142000000,-110900000
589,762,2021,2,0,130500000,-130500000
590,1123,2021,2,38400000,63550000,-25150000
591,180,2021,2,60350000,43100000,17250000
592,148,2021,2,34620000,95900000,-61280000
593,1010,2021,2,12850000,43500000,-30650000
594,379,2021,2,4240000,74500000,-70260000
595,543,2021,2,31800000,37600000,-5800000
596,13,2021,3,22750000,80700000,-57950000
597,131,2021,3,70760000,69500000,1260000
598,418,2021,3,78000000,31000000,47000000
599,368,2021,3,28500000,41500000,-13000000
600,681,2021,3,0,2500000,-2500000
601,1050,2021,3,10380000,54500000,-44120000
602,150,2021,3,14000000,3250000,10750000
603,621,2021,3,0,0,0
604,16795,2021,3,3000000,17450000,-14450000
605,940,2021,3,1800000,10020000,-8220000
606,2687,2021,3,0,6100000,-6100000
607,714,2021,3,0,6000000,-6000000
608,331,2021,3,0,8700000,-8700000
609,3368,2021,3,0,875000,-875000
610,1049,2021,3,2700000,13350000,-10650000
611,3709,2021,3,21000000,16000000,5000000
612,1108,2021,3,3500000,1150000,2350000
613,1531,2021,3,2100000,8200000,-6100000
614,237,2021,3,9000000,10000000,-1000000
615,367,2021,3,2200000,4300000,-2100000
616,27,2021,4,4000000,57500000,-53500000
617,23826,2021,4,113500000,107620000,5880000
618,16,2021,4,109500000,45000000,64500000
619,82,2021,4,22700000,76180000,-53480000
620,24,2021,4,28400000,13450000,14950000
621,15,2021,4,43100000,55350000,-12250000
622,89,2021,4,19550000,20100000,-550000
623,18,2021,4,10200000,17000000,-6800000
624,79,2021,4,40920000,14850000,26070000
625,60,2021,4,14550000,9500000,5050000
626,533,2021,4,850000,0,850000
627,39,2021,4,18050000,6900000,11150000
628,167,2021,4,12800000,24060000,-11260000
629,44,2021,4,52500000,27400000,25100000
630,10,2021,4,500000,9440000,-8940000
631,3,2021,4,23450000,550000,22900000
632,80,2021,4,350000,0,350000
633,65,2021,4,3550000,1400000,2150000
634,46,2021,5,205050000,42550000,162500000
635,5,2021,5,5120000,93110000,-87990000
636,800,2021,5,48990000,65200000,-16210000
637,506,2021,5,64030000,129500000,-65470000
638,6195,2021,5,3200000,23300000,-20100000
639,398,2021,5,8900000,13800000,-4900000
640,12,2021,5,17240000,127650000,-110410000
641,6574,2021,5,22800000,37120000,-14320000
642,1038,2021,5,9700000,14510000,-4810000
643,276,2021,5,37520000,42270000,-4750000
644,252,2021,5,18620000,39100000,-20480000
645,1025,2021,5,25000000,32310000,-7310000
646,410,2021,5,79630000,9400000,70230000
647,430,2021,5,112200000,64400000,47800000
648,3522,2021,5,2200000,27790000,-25590000
649,1390,2021,5,7370000,15200000,-7830000
650,416,2021,5,16500000,13400000,3100000
651,749,2021,5,28200000,10500000,17700000
652,380,2021,5,0,14350000,-14350000
653,607,2021,5,200000,22090000,-21890000
654,1082,2021,6,76850000,25600000,51250000
655,583,2021,6,11000000,91000000,-80000000
656,162,2021,6,34640000,45500000,-10860000
657,1041,2021,6,95600000,22920000,72680000
658,244,2021,6,8000000,54120000,-46120000
659,273,2021,6,45400000,81500000,-36100000
660,826,2021,6,18000000,20600000,-2600000
661,969,2021,6,25000000,200000,24800000
662,417,2021,6,26050000,55000000,-28950000
663,347,2021,6,23500000,2500000,21000000
664,618,2021,6,0,600000,-600000
665,40,2021,6,18600000,9800000,8800000
666,1420,2021,6,18100000,1870000,16230000
667,1421,2021,6,15050000,16000000,-950000
668,667,2021,6,16000000,4500000,11500000
669,1158,2021,6,10000000,10500000,-500000
670,3911,2021,6,28200000,9250000,18950000
671,995,2021,6,15800000,7500000,8300000
672,1095,2021,6,0,21800000,-21800000
673,3524,2021,6,0,0,0
